...############################
............#..#..#...........#
#..#F.#######..#..#..#..#..#..#
#..#.....#.....#.....#..#..#..#
####..####..#######..#..#######
#.................#..#........#
#######..#..#############..####
#........#........#..#.....#..#
#..#..##########..#..#..#..#..#
#..#..#...........#..#..#.....#
#..#######..#######..####..#..#
#..#..#..#..#..#..#........#..#
#..#..#..####..#..#..####..#..#
#...........#.....#..#..#..#..#
#..####..####..#..#..#..#######
#..#.....#.....#...........#..#
#..#..#..#############..#..#..#
#..#..#..#...........#..#.....#
#..#######..####..####..####..#
#.....S........#........#......
############################...
