...#############
......#..F..#..#
#..#..####..#..#
#..#........#..#
####..####..#..#
#........#.....#
#..#..####..####
#..#.....#.....#
####..##########
#..........S....
#############...